00000000001111111111
11111111101111111111
11111111101100000001
11111111101101111101
11111111101101111101
00000000001101111101
01111111111101111101
01111111111101111101
01111111111101111101
01111111111101111101
00000001111101111101
11111101111101111101
11111100000001111100
